11111111
100C0111
100C0111
11000111
1P0E00C1
11111111