1111111111111111111111111111111
100C011111111111111111111111111
100C011111111111111111111111111
1100011111111111111111111111111
1P0E00C111111111111111111111111
1111111111111111111111111111111