111111111
100CB1111
100C01111
110001111
1P0E00C11
111111111