111111
100111
100111
111111
1PC0E1
111111