111111111111111
100000000C00001
100111100000001
1P010E0000C0001
111111111111111