111111111
100C01001
100C01001
111000011
1E1P10C11
111111111