111111111111111
1000000C0000101
100110000000111
1P010000E000001
100000000000001
111111111111111