111111111
100CB1111
1B0C01111
110000011
1P0E00C11
111111111