1111111111111
10000000000C1
1001111100001
1P010E01000C1
1111111111111