11111111
10000111
10000111
11000111
1P0E00C1
11111111