11111111111
100000000P1
10000E000C1
10000000001
11111111111



